#########
#O  PX  #
#       #
# O X   #
#       #
#########