#####################
#            P      #
##########O      ####
#             X     #
#############     ###
#####################