#######
#OX XO#
#  P  #
#OX XO#
###############